11111111111111111111111111111111111111111111111111111111111
100000000PEC00000000000000000000000000000000000000000000001
11111111111111111111111111111111111111111111111111111111111