11111111111111111111
10010000000010000011
1001000C010010111011
10011110C10000000001
10E00000000000000001
10000000000000000011
1C00000CP00011101111
11011111111111100111
11011100000011110011
11011111111101100011
10000000000001101111
11111111111111111111
