11111111111111111111
10010000000010000011
1001000C010010111011
10011110C10000100011
1CE0000CP00011101111
11011111111111111111
11011100000011111001
11011111111101100011
11000000000001101111
11111111111111111111
