1111111
100L011
1PCEPP1
1111111
1111111