1111111111
1PE0000001
1CE1111111
1111111111
